............................................................................................................................................................................................................................................................................................................
.##################################################################################################.........................................................................................................................................................................................................
.#.............................#.................##...........................................#########..............................#################......................................................................................................................................................
.#.............................#.......+...+....##............................................#########..............................#...............#......................................................................................................................................................
.#.............................#.......|.%.|...##..............................................(======#..............................#...............#......................................................................................................................................................
.#..####======####.............#..............##...............................................(======#..............................#...............#......................................................................................................................................................
.#..####======####.............#.............##................................................(======#..............................#...............#......................................................................................................................................................
.#...()........................#............##........###......###......###...........##......#########..............................#...............#......................................................................................................................................................
.#...()........................#.......######.........#+#......#+#......#+#...........##......#########..............................#...............#####################################..................................................................................................................
.#...()........................#.......#..............#|#......#|#......#|#....................(======#..............................#...............#...................................#..................................................................................................................
.#...()........................#.......#..............###......###......###....................(======#..............................#...............#...................................#..................................................................................................................
.#...()........................#.......#.......................................................(======#..............................#...............#...................................#..................................................................................................................
.#...()..........+.....+.......#.......#..............................................##......#########..............................#...............#...................................#..................................................................................................................
.##.####.....###.|.###.|.###...####...##..............................................##......########################################...............#...................................#..................................................................................................................
.#$.####..............................................###......###......###.......................#..................................#...............#...................................#..................................................................................................................
.#$...................................................#+#......#+#......#+#.......................#..................................#...............#...................................#..................................................................................................................
.#$...................................................#|#......#|#......#|#.......................#..................................#...............#...................................#..................................................................................................................
.#$............................#############..........###......###......###........############...#..................................#...............#...................................#..................................................................................................................
.#$.####.........+.....+.......#...................................................#..............#..................................#...............#...................................#..................................................................................................................
.##.####.....###.|.###.|.###...#...................................................#..............#..................................#...............#...................................#..................................................................................................................
.#...()........................#...................................................#..##====##....#..................................#...............#...................................#..................................................................................................................
.#...()........................#...#########..........###......###......###........#..##====##....#..................................#############...#...................................#..................................................................................................................
.#...()........................#...........#..........#+#......#+#......#+#........#..............#..................................................#...................................#..................................................................................................................
.#...()........................#...........#..........#|#......#|#......#|#........#..............#..................................................#...................................#..................................................................................................................
.#...()........................#...........#..........###......###......###........#..............#..................................................#...................................#..................................................................................................................
.#...()........................#########...#.......................................#..............#......................................................................................#..................................................................................................................
.#..####======####.............#...........#.......................................#..##====##....#................#.....................................................................#..................................................................................................................
.#..####======####.............#...........#.......................................#..##====##....#................#.....................................................................#..................................................................................................................
.#.............................#...........#..........###......###......###........#..............#................#.....................................................................#..................................................................................................................
.#.............................#...#########..........#+#......#+#......#+#........#..............#................#.....................................................................#..................................................................................................................
.#.............................#...........#..........#|#......#|#......#|#........#..............#................#.................................###############.....................#..................................................................................................................
.#.............................#...........#..........###......###......###........#..............#................#.................................#.............#.....................#..................................................................................................................
.#.............................#...........#.......................................#..##====##....#................#.................................#.............#.....................#..................................................................................................................
.#.............................#...........#.......................................#..##====##....#................#.................................#.............#.....................#..................................................................................................................
.###############################...........#.......................................#..............#................#.................................#.............#.....................#..................................................................................................................
..................#........................#.......................................#..............#................#.................................#.............#.....................#..................................................................................................................
..................#........................#.......................................#..............#................#.................................#.............#.....................#..................................................................................................................
..................#........................#####################################################################...#.................................#.............#.....................#..................................................................................................................
..................#........................#..........#............................................................#.................................#.............#########.............#..................................................................................................................
..................#.......................##..........#............................................................#.................................#.............#.....................#..................................................................................................................
..................#......................##...........#............................................................#.................................#.............#.....................#..................................................................................................................
..................#.....................##............#............................................................#.................................#.............#.....................#..................................................................................................................
..................#....................##.............#............................................................#.................................#..................#................#..................................................................................................................
..................#...................##..............#............................................................#.................................#..................#................#..................................................................................................................
..................#..................##...............#............................................................#.................................#..................#................#..................................................................................................................
..................#.................##................#............................................................###############################...####...##############################..................................................................................................................
..................#................##.................#............................................................#........................#...............#...............................................................................................................................................
..................#...............##..................#............................................................#........................#...............#...............................................................................................................................................
..................#..............##...................#............................................................#........................#...............#...............................................................................................................................................
..................#.............##...........##.......#............................................................#........................#...............#...............................................................................................................................................
..................#............##...........##........#............................................................#........................#...............#...............................................................................................................................................
..................#............#...........##.........#............................................................#........................#...............#...............................................................................................................................................
..................#.......................##..........#............................................................#........................#...............#...............................................................................................................................................
..................#......................##...........#............................................................#........................#################...............................................................................................................................................
..................#.....................##............#............................................................#........................................................................................................................................................................................
..................#....................##.............#............................................................#........................................................................................................................................................................................
..................#######################.....#########............................................................#........................................................................................................................................................................................
........................................#..........................................................................#........................................................................................................................................................................................
........................................#..........................................................................#........................................................................................................................................................................................
........................................#..........................................................................#........................................................................................................................................................................................
........................................#..........................................................................#........................................................................................................................................................................................
........................................#..........................................................................#........................................................................................................................................................................................
........................................#..........................................................................#........................................................................................................................................................................................
........................................############################################################################........................................................................................................................................................................................
............................................................................................................................................................................................................................................................................................................
